,date,values-Production,values-Consumption,values-FeedIn,values-SelfConsumption,values-Purchased
0,2021-07-31 00:00:00,0.0,450,0,0,450
1,2021-07-31 01:00:00,0.0,558,0,0,558
2,2021-07-31 02:00:00,0.0,427,0,0,427
3,2021-07-31 03:00:00,0.0,618,0,0,618
4,2021-07-31 04:00:00,0.0,1046,0,0,1046
5,2021-07-31 05:00:00,0.0,468,0,0,468
6,2021-07-31 06:00:00,101.0,472,0,101,371
7,2021-07-31 07:00:00,210.0,403,0,210,193
8,2021-07-31 08:00:00,548.0,668,42,506,162
9,2021-07-31 09:00:00,745.0,612,206,539,73
10,2021-07-31 10:00:00,1237.0,804,480,757,47
11,2021-07-31 11:00:00,1156.0,1329,436,720,609
12,2021-07-31 12:00:00,1846.0,764,1100,746,18
13,2021-07-31 13:00:00,1695.0,816,907,788,28
14,2021-07-31 14:00:00,876.0,608,295,581,27
15,2021-07-31 15:00:00,1683.0,792,902,781,11
16,2021-07-31 16:00:00,901.0,905,181,720,185
17,2021-07-31 17:00:00,967.0,846,207,760,86
18,2021-07-31 18:00:00,299.0,2160,0,299,1861
19,2021-07-31 19:00:00,936.0,718,337,599,119
20,2021-07-31 20:00:00,289.0,651,42,247,404
21,2021-07-31 21:00:00,0.0,616,0,0,616
22,2021-07-31 22:00:00,0.0,835,0,0,835
23,2021-07-31 23:00:00,0.0,533,0,0,533
24,2021-08-01 00:00:00,0.0,865,0,0,865
25,2021-08-01 01:00:00,0.0,1186,0,0,1186
26,2021-08-01 02:00:00,0.0,405,0,0,405
27,2021-08-01 03:00:00,0.0,514,0,0,514
28,2021-08-01 04:00:00,0.0,398,0,0,398
29,2021-08-01 05:00:00,0.0,416,0,0,416
30,2021-08-01 06:00:00,12.0,415,0,12,403
31,2021-08-01 07:00:00,189.0,362,0,189,173
32,2021-08-01 08:00:00,497.0,679,17,480,199
33,2021-08-01 09:00:00,887.0,1211,314,573,638
34,2021-08-01 10:00:00,1260.0,1025,493,767,258
35,2021-08-01 11:00:00,1090.0,1123,226,864,259
36,2021-08-01 12:00:00,2025.0,701,1327,698,3
37,2021-08-01 13:00:00,2136.0,815,1335,801,14
38,2021-08-01 14:00:00,2235.0,644,1600,635,9
39,2021-08-01 15:00:00,1511.0,707,843,668,39
40,2021-08-01 16:00:00,1201.0,1454,372,829,625
41,2021-08-01 17:00:00,905.0,659,290,615,44
42,2021-08-01 18:00:00,1913.0,1293,721,1192,101
43,2021-08-01 19:00:00,2657.0,948,1713,944,4
44,2021-08-01 20:00:00,226.0,860,59,167,693
45,2021-08-01 21:00:00,0.0,877,0,0,877
46,2021-08-01 22:00:00,0.0,1844,0,0,1844
47,2021-08-01 23:00:00,0.0,556,0,0,556
48,2021-08-02 00:00:00,0.0,440,0,0,440
49,2021-08-02 01:00:00,0.0,409,0,0,409
50,2021-08-02 02:00:00,0.0,479,0,0,479
51,2021-08-02 03:00:00,0.0,383,0,0,383
52,2021-08-02 04:00:00,0.0,434,0,0,434
53,2021-08-02 05:00:00,0.0,555,0,0,555
54,2021-08-02 06:00:00,103.0,1153,0,103,1050
55,2021-08-02 07:00:00,326.0,510,7,319,191
56,2021-08-02 08:00:00,622.0,602,128,494,108
57,2021-08-02 09:00:00,1020.0,669,417,603,66
58,2021-08-02 10:00:00,1263.0,509,766,497,12
59,2021-08-02 11:00:00,1572.0,592,1007,565,27
60,2021-08-02 12:00:00,2218.0,1377,1039,1179,198
61,2021-08-02 13:00:00,2646.0,803,1849,797,6
62,2021-08-02 14:00:00,481.0,532,160,321,211
63,2021-08-02 15:00:00,553.0,623,74,479,144
64,2021-08-02 16:00:00,362.0,485,8,354,131
65,2021-08-02 17:00:00,476.0,607,0,476,131
66,2021-08-02 18:00:00,137.0,1506,0,137,1369
67,2021-08-02 19:00:00,12.0,1406,0,12,1394
68,2021-08-02 20:00:00,0.0,589,0,0,589
69,2021-08-02 21:00:00,0.0,947,0,0,947
70,2021-08-02 22:00:00,0.0,535,0,0,535
71,2021-08-02 23:00:00,0.0,853,0,0,853
72,2021-08-03 00:00:00,0.0,430,0,0,430
73,2021-08-03 01:00:00,0.0,1121,0,0,1121
74,2021-08-03 02:00:00,0.0,2820,0,0,2820
75,2021-08-03 03:00:00,0.0,366,0,0,366
76,2021-08-03 04:00:00,0.0,394,0,0,394
77,2021-08-03 05:00:00,0.0,404,0,0,404
78,2021-08-03 06:00:00,68.0,768,0,68,700
79,2021-08-03 07:00:00,351.0,490,27,324,166
80,2021-08-03 08:00:00,702.0,574,216,486,88
81,2021-08-03 09:00:00,679.0,833,83,596,237
82,2021-08-03 10:00:00,893.0,843,301,592,251
83,2021-08-03 11:00:00,1003.0,596,450,553,43
84,2021-08-03 12:00:00,1941.0,712,1235,706,6
85,2021-08-03 13:00:00,2391.0,661,1754,637,24
86,2021-08-03 14:00:00,1704.0,800,955,749,51
87,2021-08-03 15:00:00,2214.0,736,1482,732,4
88,2021-08-03 16:00:00,3206.0,992,2214,992,0
89,2021-08-03 17:00:00,4141.0,1696,2446,1695,1
90,2021-08-03 18:00:00,3166.0,1146,2123,1043,103
91,2021-08-03 19:00:00,693.0,1050,280,413,637
92,2021-08-03 20:00:00,86.0,724,0,86,638
93,2021-08-03 21:00:00,0.0,1165,0,0,1165
94,2021-08-03 22:00:00,0.0,444,0,0,444
95,2021-08-03 23:00:00,0.0,1400,0,0,1400
96,2021-08-04 00:00:00,0.0,427,0,0,427
97,2021-08-04 01:00:00,0.0,582,0,0,582
98,2021-08-04 02:00:00,0.0,444,0,0,444
99,2021-08-04 03:00:00,0.0,366,0,0,366
100,2021-08-04 04:00:00,0.0,1029,0,0,1029
101,2021-08-04 05:00:00,0.0,514,0,0,514
102,2021-08-04 06:00:00,114.0,436,0,114,322
103,2021-08-04 07:00:00,373.0,637,3,370,267
104,2021-08-04 08:00:00,422.0,421,29,393,28
105,2021-08-04 09:00:00,379.0,533,0,379,154
106,2021-08-04 10:00:00,751.0,737,189,562,175
107,2021-08-04 11:00:00,1072.0,1354,365,707,647
108,2021-08-04 12:00:00,1910.0,807,1114,796,11
109,2021-08-04 13:00:00,2696.0,773,1923,773,0
110,2021-08-04 14:00:00,2723.0,822,1919,804,18
111,2021-08-04 15:00:00,2876.0,1150,1797,1079,71
112,2021-08-04 16:00:00,3398.0,898,2504,894,4
113,2021-08-04 17:00:00,3088.0,955,2137,951,4
114,2021-08-04 18:00:00,2335.0,2212,670,1665,547
115,2021-08-04 19:00:00,632.0,640,166,466,174
116,2021-08-04 20:00:00,42.0,990,0,42,948
117,2021-08-04 21:00:00,0.0,690,0,0,690
118,2021-08-04 22:00:00,0.0,846,0,0,846
119,2021-08-04 23:00:00,0.0,394,0,0,394
120,2021-08-05 00:00:00,0.0,534,0,0,534
121,2021-08-05 01:00:00,0.0,1025,0,0,1025
122,2021-08-05 02:00:00,0.0,502,0,0,502
123,2021-08-05 03:00:00,0.0,325,0,0,325
124,2021-08-05 04:00:00,0.0,424,0,0,424
125,2021-08-05 05:00:00,0.0,411,0,0,411
126,2021-08-05 06:00:00,137.0,381,0,137,244
127,2021-08-05 07:00:00,225.0,666,0,225,441
128,2021-08-05 08:00:00,691.0,1444,173,518,926
129,2021-08-05 09:00:00,758.0,669,216,542,127
130,2021-08-05 10:00:00,1046.0,957,308,738,219
131,2021-08-05 11:00:00,1167.0,616,576,591,25
132,2021-08-05 12:00:00,1107.0,827,377,730,97
133,2021-08-05 13:00:00,655.0,551,165,490,61
134,2021-08-05 14:00:00,710.0,559,195,515,44
135,2021-08-05 15:00:00,764.0,1091,180,584,507
136,2021-08-05 16:00:00,579.0,824,165,414,410
137,2021-08-05 17:00:00,233.0,556,0,233,323
138,2021-08-05 18:00:00,166.0,1394,0,166,1228
139,2021-08-05 19:00:00,733.0,1119,312,421,698
140,2021-08-05 20:00:00,35.0,662,0,35,627
141,2021-08-05 21:00:00,0.0,859,0,0,859
142,2021-08-05 22:00:00,0.0,1299,0,0,1299
143,2021-08-05 23:00:00,0.0,805,0,0,805
144,2021-08-06 00:00:00,0.0,511,0,0,511
145,2021-08-06 01:00:00,0.0,360,0,0,360
146,2021-08-06 02:00:00,0.0,515,0,0,515
147,2021-08-06 03:00:00,0.0,444,0,0,444
148,2021-08-06 04:00:00,0.0,494,0,0,494
149,2021-08-06 05:00:00,0.0,917,0,0,917
150,2021-08-06 06:00:00,33.0,499,0,33,466
151,2021-08-06 07:00:00,289.0,1062,17,272,790
152,2021-08-06 08:00:00,562.0,815,49,513,302
153,2021-08-06 09:00:00,556.0,662,90,466,196
154,2021-08-06 10:00:00,1043.0,831,394,649,182
155,2021-08-06 11:00:00,1303.0,749,583,720,29
156,2021-08-06 12:00:00,1963.0,956,1115,848,108
157,2021-08-06 13:00:00,2678.0,1383,1504,1174,209
158,2021-08-06 14:00:00,3292.0,1183,2120,1172,11
159,2021-08-06 15:00:00,2198.0,730,1492,706,24
160,2021-08-06 16:00:00,2770.0,885,1888,882,3
161,2021-08-06 17:00:00,1501.0,697,843,658,39
162,2021-08-06 18:00:00,388.0,1861,9,379,1482
163,2021-08-06 19:00:00,836.0,813,295,541,272
164,2021-08-06 20:00:00,26.0,705,0,26,679
165,2021-08-06 21:00:00,0.0,702,0,0,702
166,2021-08-06 22:00:00,0.0,457,0,0,457
167,2021-08-06 23:00:00,0.0,546,0,0,546
168,2021-08-07 00:00:00,0.0,597,0,0,597
169,2021-08-07 01:00:00,0.0,1239,0,0,1239
170,2021-08-07 02:00:00,0.0,363,0,0,363
171,2021-08-07 03:00:00,0.0,394,0,0,394
172,2021-08-07 04:00:00,0.0,385,0,0,385
173,2021-08-07 05:00:00,0.0,423,0,0,423
174,2021-08-07 06:00:00,59.0,442,0,59,383
175,2021-08-07 07:00:00,258.0,515,0,258,257
176,2021-08-07 08:00:00,348.0,1172,6,342,830
177,2021-08-07 09:00:00,982.0,824,355,627,197
178,2021-08-07 10:00:00,1012.0,1004,321,691,313
179,2021-08-07 11:00:00,1125.0,665,505,620,45
180,2021-08-07 12:00:00,1777.0,1031,986,791,240
181,2021-08-07 13:00:00,2478.0,757,1724,754,3
182,2021-08-07 14:00:00,2494.0,822,1725,769,53
183,2021-08-07 15:00:00,1605.0,1680,473,1132,548
184,2021-08-07 16:00:00,2031.0,839,1209,822,17
185,2021-08-07 17:00:00,1033.0,892,380,653,239
186,2021-08-07 18:00:00,2424.0,1159,1361,1063,96
187,2021-08-07 19:00:00,664.0,607,297,367,240
188,2021-08-07 20:00:00,15.0,1089,0,15,1074
189,2021-08-07 21:00:00,0.0,1392,0,0,1392
190,2021-08-07 22:00:00,0.0,546,0,0,546
191,2021-08-07 23:00:00,0.0,528,0,0,528
192,2021-08-08 00:00:00,0.0,387,0,0,387
193,2021-08-08 01:00:00,0.0,444,0,0,444
194,2021-08-08 02:00:00,0.0,405,0,0,405
195,2021-08-08 03:00:00,0.0,427,0,0,427
196,2021-08-08 04:00:00,0.0,1094,0,0,1094
197,2021-08-08 05:00:00,0.0,367,0,0,367
198,2021-08-08 06:00:00,10.0,500,0,10,490
199,2021-08-08 07:00:00,141.0,492,0,141,351
200,2021-08-08 08:00:00,358.0,776,16,342,434
201,2021-08-08 09:00:00,558.0,502,112,446,56
202,2021-08-08 10:00:00,827.0,1010,183,644,366
203,2021-08-08 11:00:00,1446.0,1326,776,670,656
204,2021-08-08 12:00:00,1750.0,680,1084,666,14
205,2021-08-08 13:00:00,2256.0,770,1488,768,2
206,2021-08-08 14:00:00,1644.0,648,1001,643,5
207,2021-08-08 15:00:00,1653.0,820,864,789,31
208,2021-08-08 16:00:00,3327.0,942,2385,942,0
209,2021-08-08 17:00:00,4276.0,2430,2249,2027,403
210,2021-08-08 18:00:00,3289.0,2949,1245,2044,905
211,2021-08-08 19:00:00,1682.0,1484,523,1159,325
212,2021-08-08 20:00:00,124.0,1126,0,124,1002
213,2021-08-08 21:00:00,0.0,1151,0,0,1151
214,2021-08-08 22:00:00,0.0,551,0,0,551
215,2021-08-08 23:00:00,0.0,447,0,0,447
216,2021-08-09 00:00:00,0.0,507,0,0,507
217,2021-08-09 01:00:00,0.0,1240,0,0,1240
218,2021-08-09 02:00:00,0.0,475,0,0,475
219,2021-08-09 03:00:00,0.0,398,0,0,398
220,2021-08-09 04:00:00,0.0,430,0,0,430
221,2021-08-09 05:00:00,0.0,426,0,0,426
222,2021-08-09 06:00:00,21.0,508,0,21,487
223,2021-08-09 07:00:00,201.0,1121,3,198,923
224,2021-08-09 08:00:00,728.0,877,188,540,337
225,2021-08-09 09:00:00,658.0,824,104,554,270
226,2021-08-09 10:00:00,969.0,642,382,587,55
227,2021-08-09 11:00:00,1086.0,673,448,638,35
228,2021-08-09 12:00:00,1603.0,1406,724,879,527
229,2021-08-09 13:00:00,2621.0,770,1852,769,1
230,2021-08-09 14:00:00,2249.0,859,1392,857,2
231,2021-08-09 15:00:00,1319.0,635,713,606,29
232,2021-08-09 16:00:00,2420.0,986,1446,974,12
233,2021-08-09 17:00:00,1576.0,1881,501,1075,806
234,2021-08-09 18:00:00,558.0,2287,0,558,1729
235,2021-08-09 19:00:00,1584.0,1441,495,1089,352
236,2021-08-09 20:00:00,230.0,839,19,211,628
237,2021-08-09 21:00:00,0.0,984,0,0,984
238,2021-08-09 22:00:00,0.0,562,0,0,562
239,2021-08-09 23:00:00,0.0,457,0,0,457
240,2021-08-10 00:00:00,0.0,554,0,0,554
241,2021-08-10 01:00:00,0.0,426,0,0,426
242,2021-08-10 02:00:00,0.0,2941,0,0,2941
243,2021-08-10 03:00:00,0.0,726,0,0,726
244,2021-08-10 04:00:00,0.0,448,0,0,448
245,2021-08-10 05:00:00,0.0,329,0,0,329
246,2021-08-10 06:00:00,64.0,835,0,64,771
247,2021-08-10 07:00:00,353.0,612,4,349,263
248,2021-08-10 08:00:00,599.0,584,101,498,86
249,2021-08-10 09:00:00,643.0,646,62,581,65
250,2021-08-10 10:00:00,774.0,1361,137,637,724
251,2021-08-10 11:00:00,1229.0,699,551,678,21
252,2021-08-10 12:00:00,1803.0,868,959,844,24
253,2021-08-10 13:00:00,1790.0,749,1060,730,19
254,2021-08-10 14:00:00,2075.0,1648,1133,942,706
255,2021-08-10 15:00:00,2419.0,888,1563,856,32
256,2021-08-10 16:00:00,2136.0,1554,1219,917,637
257,2021-08-10 17:00:00,3922.0,1412,2537,1385,27
258,2021-08-10 18:00:00,3503.0,1500,2064,1439,61
259,2021-08-10 19:00:00,1992.0,685,1340,652,33
260,2021-08-10 20:00:00,188.0,562,48,140,422
261,2021-08-10 21:00:00,0.0,625,0,0,625
262,2021-08-10 22:00:00,0.0,1326,0,0,1326
263,2021-08-10 23:00:00,0.0,397,0,0,397
264,2021-08-11 00:00:00,0.0,484,0,0,484
265,2021-08-11 01:00:00,0.0,381,0,0,381
266,2021-08-11 02:00:00,0.0,462,0,0,462
267,2021-08-11 03:00:00,0.0,378,0,0,378
268,2021-08-11 04:00:00,0.0,415,0,0,415
269,2021-08-11 05:00:00,0.0,621,0,0,621
270,2021-08-11 06:00:00,43.0,1101,0,43,1058
271,2021-08-11 07:00:00,223.0,542,0,223,319
272,2021-08-11 08:00:00,267.0,618,0,267,351
273,2021-08-11 09:00:00,353.0,893,0,353,540
274,2021-08-11 10:00:00,774.0,1304,131,643,661
275,2021-08-11 11:00:00,1291.0,712,631,660,52
276,2021-08-11 12:00:00,1559.0,1756,334,1225,531
277,2021-08-11 13:00:00,2403.0,868,1566,837,31
278,2021-08-11 14:00:00,2119.0,1133,1004,1115,18
279,2021-08-11 15:00:00,2608.0,726,1888,720,6
280,2021-08-11 16:00:00,2653.0,812,1866,787,25
281,2021-08-11 17:00:00,2157.0,1070,1167,990,80
282,2021-08-11 18:00:00,1237.0,1776,297,940,836
283,2021-08-11 19:00:00,1079.0,1077,459,620,457
284,2021-08-11 20:00:00,21.0,784,0,21,763
285,2021-08-11 21:00:00,0.0,1148,0,0,1148
286,2021-08-11 22:00:00,0.0,493,0,0,493
287,2021-08-11 23:00:00,0.0,496,0,0,496
288,2021-08-12 00:00:00,0.0,448,0,0,448
289,2021-08-12 01:00:00,0.0,1064,0,0,1064
290,2021-08-12 02:00:00,0.0,415,0,0,415
291,2021-08-12 03:00:00,0.0,401,0,0,401
292,2021-08-12 04:00:00,0.0,381,0,0,381
293,2021-08-12 05:00:00,0.0,409,0,0,409
294,2021-08-12 06:00:00,44.0,415,0,44,371
295,2021-08-12 07:00:00,283.0,490,0,283,207
296,2021-08-12 08:00:00,323.0,1213,0,323,890
297,2021-08-12 09:00:00,764.0,713,243,521,192
298,2021-08-12 10:00:00,818.0,915,161,657,258
299,2021-08-12 11:00:00,1136.0,565,587,549,16
300,2021-08-12 12:00:00,1065.0,632,495,570,62
301,2021-08-12 13:00:00,1094.0,637,560,534,103
302,2021-08-12 14:00:00,991.0,742,385,606,136
303,2021-08-12 15:00:00,2242.0,1145,1357,885,260
304,2021-08-12 16:00:00,1220.0,916,458,762,154
305,2021-08-12 17:00:00,933.0,635,359,574,61
306,2021-08-12 18:00:00,1605.0,1670,577,1028,642
307,2021-08-12 19:00:00,1556.0,800,951,605,195
308,2021-08-12 20:00:00,8.0,857,0,8,849
309,2021-08-12 21:00:00,0.0,1647,0,0,1647
310,2021-08-12 22:00:00,0.0,855,0,0,855
311,2021-08-12 23:00:00,0.0,532,0,0,532
312,2021-08-13 00:00:00,0.0,330,0,0,330
313,2021-08-13 01:00:00,0.0,544,0,0,544
314,2021-08-13 02:00:00,0.0,729,0,0,729
315,2021-08-13 03:00:00,0.0,1130,0,0,1130
316,2021-08-13 04:00:00,0.0,437,0,0,437
317,2021-08-13 05:00:00,0.0,433,0,0,433
318,2021-08-13 06:00:00,24.0,513,0,24,489
319,2021-08-13 07:00:00,226.0,551,0,226,325
320,2021-08-13 08:00:00,443.0,691,1,442,249
321,2021-08-13 09:00:00,814.0,817,235,579,238
322,2021-08-13 10:00:00,1359.0,1577,347,1012,565
323,2021-08-13 11:00:00,940.0,709,315,625,84
324,2021-08-13 12:00:00,1338.0,754,617,721,33
325,2021-08-13 13:00:00,1684.0,623,1078,606,17
326,2021-08-13 14:00:00,1707.0,850,887,820,30
327,2021-08-13 15:00:00,2576.0,795,1795,781,14
328,2021-08-13 16:00:00,1887.0,749,1152,735,14
329,2021-08-13 17:00:00,1849.0,1412,891,958,454
330,2021-08-13 18:00:00,1856.0,832,1092,764,68
331,2021-08-13 19:00:00,139.0,540,0,139,401
332,2021-08-13 20:00:00,0.0,385,0,0,385
333,2021-08-13 21:00:00,0.0,546,0,0,546
334,2021-08-13 22:00:00,0.0,449,0,0,449
335,2021-08-13 23:00:00,0.0,485,0,0,485
336,2021-08-14 00:00:00,0.0,402,0,0,402
337,2021-08-14 01:00:00,0.0,1164,0,0,1164
338,2021-08-14 02:00:00,0.0,426,0,0,426
339,2021-08-14 03:00:00,0.0,424,0,0,424
340,2021-08-14 04:00:00,0.0,354,0,0,354
341,2021-08-14 05:00:00,0.0,445,0,0,445
342,2021-08-14 06:00:00,58.0,409,0,58,351
343,2021-08-14 07:00:00,274.0,513,0,274,239
344,2021-08-14 08:00:00,519.0,1115,105,414,701
345,2021-08-14 09:00:00,728.0,783,125,603,180
346,2021-08-14 10:00:00,729.0,1168,96,633,535
347,2021-08-14 11:00:00,1019.0,1648,128,891,757
348,2021-08-14 12:00:00,1259.0,827,500,759,68
349,2021-08-14 13:00:00,2129.0,871,1284,845,26
350,2021-08-14 14:00:00,2973.0,923,2071,902,21
351,2021-08-14 15:00:00,1697.0,879,886,811,68
352,2021-08-14 16:00:00,1931.0,1606,811,1120,486
353,2021-08-14 17:00:00,3938.0,986,2952,986,0
354,2021-08-14 18:00:00,1395.0,955,596,799,156
355,2021-08-14 19:00:00,698.0,895,174,524,371
356,2021-08-14 20:00:00,16.0,763,0,16,747
357,2021-08-14 21:00:00,0.0,794,0,0,794
358,2021-08-14 22:00:00,0.0,1476,0,0,1476
359,2021-08-14 23:00:00,0.0,516,0,0,516
360,2021-08-15 00:00:00,0.0,520,0,0,520
361,2021-08-15 01:00:00,0.0,495,0,0,495
362,2021-08-15 02:00:00,0.0,504,0,0,504
363,2021-08-15 03:00:00,0.0,437,0,0,437
364,2021-08-15 04:00:00,0.0,429,0,0,429
365,2021-08-15 05:00:00,0.0,671,0,0,671
366,2021-08-15 06:00:00,0.0,1477,0,0,1477
367,2021-08-15 07:00:00,194.0,450,10,184,266
368,2021-08-15 08:00:00,516.0,575,25,491,84
369,2021-08-15 09:00:00,620.0,679,100,520,159
370,2021-08-15 10:00:00,804.0,950,195,609,341
371,2021-08-15 11:00:00,1344.0,800,564,780,20
372,2021-08-15 12:00:00,1818.0,1721,625,1193,528
373,2021-08-15 13:00:00,2036.0,934,1118,918,16
374,2021-08-15 14:00:00,2230.0,1122,1252,978,144
375,2021-08-15 15:00:00,1386.0,826,599,787,39
376,2021-08-15 16:00:00,439.0,936,4,435,501
377,2021-08-15 17:00:00,269.0,1231,0,269,962
378,2021-08-15 18:00:00,565.0,2031,37,528,1503
379,2021-08-15 19:00:00,1517.0,1359,756,761,598
380,2021-08-15 20:00:00,18.0,945,0,18,927
381,2021-08-15 21:00:00,0.0,791,0,0,791
382,2021-08-15 22:00:00,0.0,1164,0,0,1164
383,2021-08-15 23:00:00,0.0,456,0,0,456
384,2021-08-16 00:00:00,0.0,547,0,0,547
385,2021-08-16 01:00:00,0.0,457,0,0,457
386,2021-08-16 02:00:00,0.0,552,0,0,552
387,2021-08-16 03:00:00,0.0,1221,0,0,1221
388,2021-08-16 04:00:00,0.0,399,0,0,399
389,2021-08-16 05:00:00,0.0,462,0,0,462
390,2021-08-16 06:00:00,38.0,453,0,38,415
391,2021-08-16 07:00:00,249.0,559,0,249,310
392,2021-08-16 08:00:00,494.0,518,82,412,106
393,2021-08-16 09:00:00,860.0,837,270,590,247
394,2021-08-16 10:00:00,1103.0,1515,377,726,789
395,2021-08-16 11:00:00,1656.0,842,873,783,59
396,2021-08-16 12:00:00,1501.0,810,780,721,89
397,2021-08-16 13:00:00,1479.0,917,718,761,156
398,2021-08-16 14:00:00,2122.0,1257,930,1192,65
399,2021-08-16 15:00:00,1119.0,573,562,557,16
400,2021-08-16 16:00:00,923.0,683,280,643,40
401,2021-08-16 17:00:00,2265.0,1961,759,1506,455
402,2021-08-16 18:00:00,1229.0,1368,474,755,613
403,2021-08-16 19:00:00,442.0,1250,0,442,808
404,2021-08-16 20:00:00,38.0,898,0,38,860
405,2021-08-16 21:00:00,0.0,963,0,0,963
406,2021-08-16 22:00:00,0.0,482,0,0,482
407,2021-08-16 23:00:00,0.0,401,0,0,401
408,2021-08-17 00:00:00,0.0,1548,0,0,1548
409,2021-08-17 01:00:00,0.0,474,0,0,474
410,2021-08-17 02:00:00,0.0,2564,0,0,2564
411,2021-08-17 03:00:00,0.0,448,0,0,448
412,2021-08-17 04:00:00,0.0,384,0,0,384
413,2021-08-17 05:00:00,0.0,413,0,0,413
414,2021-08-17 06:00:00,0.0,431,0,0,431
415,2021-08-17 07:00:00,94.0,450,0,94,356
416,2021-08-17 08:00:00,438.0,579,39,399,180
417,2021-08-17 09:00:00,805.0,698,211,594,104
418,2021-08-17 10:00:00,806.0,566,272,534,32
419,2021-08-17 11:00:00,1284.0,832,544,740,92
420,2021-08-17 12:00:00,1036.0,720,451,585,135
421,2021-08-17 13:00:00,426.0,1112,1,425,687
422,2021-08-17 14:00:00,338.0,956,0,338,618
423,2021-08-17 15:00:00,571.0,696,26,545,151
424,2021-08-17 16:00:00,683.0,594,146,537,57
425,2021-08-17 17:00:00,581.0,1655,18,563,1092
426,2021-08-17 18:00:00,220.0,888,0,220,668
427,2021-08-17 19:00:00,63.0,915,0,63,852
428,2021-08-17 20:00:00,0.0,747,0,0,747
429,2021-08-17 21:00:00,0.0,1084,0,0,1084
430,2021-08-17 22:00:00,0.0,445,0,0,445
431,2021-08-17 23:00:00,0.0,891,0,0,891
432,2021-08-18 00:00:00,0.0,786,0,0,786
433,2021-08-18 01:00:00,0.0,562,0,0,562
434,2021-08-18 02:00:00,0.0,366,0,0,366
435,2021-08-18 03:00:00,0.0,420,0,0,420
436,2021-08-18 04:00:00,0.0,405,0,0,405
437,2021-08-18 05:00:00,0.0,432,0,0,432
438,2021-08-18 06:00:00,33.0,397,0,33,364
439,2021-08-18 07:00:00,243.0,647,0,243,404
440,2021-08-18 08:00:00,438.0,1333,12,426,907
441,2021-08-18 09:00:00,647.0,834,56,591,243
442,2021-08-18 10:00:00,941.0,824,267,674,150
443,2021-08-18 11:00:00,1140.0,838,438,702,136
444,2021-08-18 12:00:00,1660.0,776,932,728,48
445,2021-08-18 13:00:00,1773.0,729,1053,720,9
446,2021-08-18 14:00:00,2924.0,858,2068,856,2
447,2021-08-18 15:00:00,2805.0,1405,1498,1307,98
448,2021-08-18 16:00:00,3729.0,1376,2384,1345,31
449,2021-08-18 17:00:00,595.0,731,54,541,190
450,2021-08-18 18:00:00,346.0,1827,0,346,1481
451,2021-08-18 19:00:00,56.0,1149,0,56,1093
452,2021-08-18 20:00:00,0.0,1198,0,0,1198
453,2021-08-18 21:00:00,0.0,662,0,0,662
454,2021-08-18 22:00:00,0.0,1602,0,0,1602
455,2021-08-18 23:00:00,0.0,512,0,0,512
456,2021-08-19 00:00:00,0.0,460,0,0,460
457,2021-08-19 01:00:00,0.0,507,0,0,507
458,2021-08-19 02:00:00,0.0,405,0,0,405
459,2021-08-19 03:00:00,0.0,445,0,0,445
460,2021-08-19 04:00:00,0.0,394,0,0,394
461,2021-08-19 05:00:00,0.0,380,0,0,380
462,2021-08-19 06:00:00,25.0,456,0,25,431
463,2021-08-19 07:00:00,246.0,1551,0,246,1305
464,2021-08-19 08:00:00,435.0,589,29,406,183
465,2021-08-19 09:00:00,494.0,757,37,457,300
466,2021-08-19 10:00:00,1218.0,672,609,609,63
467,2021-08-19 11:00:00,1550.0,754,822,728,26
468,2021-08-19 12:00:00,1777.0,699,1095,682,17
469,2021-08-19 13:00:00,1608.0,1263,808,800,463
470,2021-08-19 14:00:00,2431.0,1188,1326,1105,83
471,2021-08-19 15:00:00,1350.0,703,673,677,26
472,2021-08-19 16:00:00,2078.0,796,1289,789,7
473,2021-08-19 17:00:00,2168.0,751,1572,596,155
474,2021-08-19 18:00:00,1728.0,1881,347,1381,500
475,2021-08-19 19:00:00,599.0,736,245,354,382
476,2021-08-19 20:00:00,13.0,845,0,13,832
477,2021-08-19 21:00:00,0.0,568,0,0,568
478,2021-08-19 22:00:00,0.0,1017,0,0,1017
479,2021-08-19 23:00:00,0.0,451,0,0,451
480,2021-08-20 00:00:00,0.0,558,0,0,558
481,2021-08-20 01:00:00,0.0,1073,0,0,1073
482,2021-08-20 02:00:00,0.0,488,0,0,488
483,2021-08-20 03:00:00,0.0,357,0,0,357
484,2021-08-20 04:00:00,0.0,487,0,0,487
485,2021-08-20 05:00:00,0.0,378,0,0,378
486,2021-08-20 06:00:00,21.0,456,0,21,435
487,2021-08-20 07:00:00,243.0,518,1,242,276
488,2021-08-20 08:00:00,481.0,542,65,416,126
489,2021-08-20 09:00:00,870.0,1253,184,686,567
490,2021-08-20 10:00:00,1016.0,1026,400,616,410
491,2021-08-20 11:00:00,1377.0,770,657,720,50
492,2021-08-20 12:00:00,1400.0,1119,448,952,167
493,2021-08-20 13:00:00,1294.0,889,514,780,109
494,2021-08-20 14:00:00,1093.0,672,511,582,90
495,2021-08-20 15:00:00,1193.0,964,397,796,168
496,2021-08-20 16:00:00,677.0,1025,26,651,374
497,2021-08-20 17:00:00,299.0,1560,0,299,1261
498,2021-08-20 18:00:00,442.0,625,15,427,198
499,2021-08-20 19:00:00,103.0,1453,0,103,1350
500,2021-08-20 20:00:00,0.0,704,0,0,704
501,2021-08-20 21:00:00,0.0,1013,0,0,1013
502,2021-08-20 22:00:00,0.0,1265,0,0,1265
503,2021-08-20 23:00:00,0.0,944,0,0,944
504,2021-08-21 00:00:00,0.0,345,0,0,345
505,2021-08-21 01:00:00,0.0,557,0,0,557
506,2021-08-21 02:00:00,0.0,441,0,0,441
507,2021-08-21 03:00:00,0.0,524,0,0,524
508,2021-08-21 04:00:00,0.0,429,0,0,429
509,2021-08-21 05:00:00,0.0,532,0,0,532
510,2021-08-21 06:00:00,0.0,645,0,0,645
511,2021-08-21 07:00:00,82.0,891,0,82,809
512,2021-08-21 08:00:00,225.0,567,0,225,342
513,2021-08-21 09:00:00,339.0,1113,0,339,774
514,2021-08-21 10:00:00,843.0,611,289,554,57
515,2021-08-21 11:00:00,786.0,593,239,547,46
516,2021-08-21 12:00:00,480.0,1899,6,474,1425
517,2021-08-21 13:00:00,328.0,681,1,327,354
518,2021-08-21 14:00:00,226.0,1467,0,226,1241
519,2021-08-21 15:00:00,482.0,583,123,359,224
520,2021-08-21 16:00:00,1711.0,905,948,763,142
521,2021-08-21 17:00:00,1032.0,1901,331,701,1200
522,2021-08-21 18:00:00,1202.0,1606,395,807,799
523,2021-08-21 19:00:00,361.0,687,70,291,396
524,2021-08-21 20:00:00,1.0,940,0,1,939
525,2021-08-21 21:00:00,0.0,726,0,0,726
526,2021-08-21 22:00:00,0.0,883,0,0,883
527,2021-08-21 23:00:00,0.0,418,0,0,418
528,2021-08-22 00:00:00,0.0,659,0,0,659
529,2021-08-22 01:00:00,0.0,1021,0,0,1021
530,2021-08-22 02:00:00,0.0,412,0,0,412
531,2021-08-22 03:00:00,0.0,428,0,0,428
532,2021-08-22 04:00:00,0.0,443,0,0,443
533,2021-08-22 05:00:00,0.0,420,0,0,420
534,2021-08-22 06:00:00,10.0,444,0,10,434
535,2021-08-22 07:00:00,163.0,591,0,163,428
536,2021-08-22 08:00:00,275.0,1639,0,275,1364
537,2021-08-22 09:00:00,715.0,893,234,481,412
538,2021-08-22 10:00:00,847.0,1118,180,667,451
539,2021-08-22 11:00:00,1367.0,1748,110,1257,491
540,2021-08-22 12:00:00,1546.0,1595,259,1287,308
541,2021-08-22 13:00:00,2121.0,1829,651,1470,359
542,2021-08-22 14:00:00,2875.0,2314,1051,1824,490
543,2021-08-22 15:00:00,3989.0,1903,2235,1754,149
544,2021-08-22 16:00:00,4091.0,2833,1386,2705,128
545,2021-08-22 17:00:00,3758.0,999,2775,983,16
546,2021-08-22 18:00:00,3089.0,2395,1098,1991,404
547,2021-08-22 19:00:00,1383.0,686,818,565,121
548,2021-08-22 20:00:00,6.0,1132,0,6,1126
549,2021-08-22 21:00:00,0.0,674,0,0,674
550,2021-08-22 22:00:00,0.0,1630,0,0,1630
551,2021-08-22 23:00:00,0.0,528,0,0,528
552,2021-08-23 00:00:00,0.0,460,0,0,460
553,2021-08-23 01:00:00,0.0,512,0,0,512
554,2021-08-23 02:00:00,0.0,433,0,0,433
555,2021-08-23 03:00:00,0.0,354,0,0,354
556,2021-08-23 04:00:00,0.0,509,0,0,509
557,2021-08-23 05:00:00,0.0,495,0,0,495
558,2021-08-23 06:00:00,2.0,645,0,2,643
559,2021-08-23 07:00:00,152.0,466,0,152,314
560,2021-08-23 08:00:00,432.0,520,37,395,125
561,2021-08-23 09:00:00,783.0,2745,26,757,1988
562,2021-08-23 10:00:00,850.0,1042,117,733,309
563,2021-08-23 11:00:00,753.0,1141,17,736,405
564,2021-08-23 12:00:00,1119.0,1527,168,951,576
565,2021-08-23 13:00:00,2064.0,1305,1062,1002,303
566,2021-08-23 14:00:00,3249.0,1140,2115,1134,6
567,2021-08-23 15:00:00,3663.0,2756,1149,2514,242
568,2021-08-23 16:00:00,4074.0,1070,3013,1061,9
569,2021-08-23 17:00:00,4019.0,997,3022,997,0
570,2021-08-23 18:00:00,3302.0,1181,2169,1133,48
571,2021-08-23 19:00:00,752.0,2483,6,746,1737
572,2021-08-23 20:00:00,0.0,1062,0,0,1062
573,2021-08-23 21:00:00,0.0,898,0,0,898
574,2021-08-23 22:00:00,0.0,811,0,0,811
575,2021-08-23 23:00:00,0.0,541,0,0,541
576,2021-08-24 00:00:00,0.0,387,0,0,387
577,2021-08-24 01:00:00,0.0,498,0,0,498
578,2021-08-24 02:00:00,0.0,2975,0,0,2975
579,2021-08-24 03:00:00,0.0,713,0,0,713
580,2021-08-24 04:00:00,0.0,345,0,0,345
581,2021-08-24 05:00:00,0.0,451,0,0,451
582,2021-08-24 06:00:00,21.0,742,0,21,721
583,2021-08-24 07:00:00,243.0,486,2,241,245
584,2021-08-24 08:00:00,332.0,568,1,331,237
585,2021-08-24 09:00:00,408.0,456,22,386,70
586,2021-08-24 10:00:00,707.0,569,163,544,25
587,2021-08-24 11:00:00,884.0,1183,154,730,453
588,2021-08-24 12:00:00,1773.0,1014,925,848,166
589,2021-08-24 13:00:00,2747.0,1369,1467,1280,89
590,2021-08-24 14:00:00,2964.0,1478,1542,1422,56
591,2021-08-24 15:00:00,3620.0,1195,2475,1145,50
592,2021-08-24 16:00:00,3801.0,891,2910,891,0
593,2021-08-24 17:00:00,3558.0,1938,1623,1935,3
594,2021-08-24 18:00:00,2543.0,1630,1173,1370,260
595,2021-08-24 19:00:00,1350.0,1735,544,806,929
596,2021-08-24 20:00:00,3.0,613,0,3,610
597,2021-08-24 21:00:00,0.0,638,0,0,638
598,2021-08-24 22:00:00,0.0,583,0,0,583
599,2021-08-24 23:00:00,0.0,1667,0,0,1667
600,2021-08-25 00:00:00,0.0,868,0,0,868
601,2021-08-25 01:00:00,0.0,966,0,0,966
602,2021-08-25 02:00:00,0.0,456,0,0,456
603,2021-08-25 03:00:00,0.0,483,0,0,483
604,2021-08-25 04:00:00,0.0,284,0,0,284
605,2021-08-25 05:00:00,0.0,529,0,0,529
606,2021-08-25 06:00:00,10.0,387,0,10,377
607,2021-08-25 07:00:00,211.0,555,0,211,344
608,2021-08-25 08:00:00,565.0,1259,114,451,808
609,2021-08-25 09:00:00,934.0,813,265,669,144
610,2021-08-25 10:00:00,1149.0,1491,317,832,659
611,2021-08-25 11:00:00,1359.0,762,668,691,71
612,2021-08-25 12:00:00,1665.0,1337,493,1172,165
613,2021-08-25 13:00:00,1869.0,1355,848,1021,334
614,2021-08-25 14:00:00,2816.0,865,1953,863,2
615,2021-08-25 15:00:00,2506.0,1654,1114,1392,262
616,2021-08-25 16:00:00,1321.0,1319,160,1161,158
617,2021-08-25 17:00:00,534.0,752,36,498,254
618,2021-08-25 18:00:00,263.0,1137,0,263,874
619,2021-08-25 19:00:00,38.0,1801,0,38,1763
620,2021-08-25 20:00:00,0.0,903,0,0,903
621,2021-08-25 21:00:00,0.0,762,0,0,762
622,2021-08-25 22:00:00,0.0,976,0,0,976
623,2021-08-25 23:00:00,0.0,581,0,0,581
624,2021-08-26 00:00:00,0.0,497,0,0,497
625,2021-08-26 01:00:00,0.0,489,0,0,489
626,2021-08-26 02:00:00,0.0,455,0,0,455
627,2021-08-26 03:00:00,0.0,1038,0,0,1038
628,2021-08-26 04:00:00,0.0,483,0,0,483
629,2021-08-26 05:00:00,0.0,338,0,0,338
630,2021-08-26 06:00:00,0.0,494,0,0,494
631,2021-08-26 07:00:00,172.0,409,4,168,241
632,2021-08-26 08:00:00,495.0,656,26,469,187
633,2021-08-26 09:00:00,891.0,649,335,556,93
634,2021-08-26 10:00:00,696.0,1560,89,607,953
635,2021-08-26 11:00:00,728.0,686,142,586,100
636,2021-08-26 12:00:00,1527.0,633,906,621,12
637,2021-08-26 13:00:00,2488.0,815,1675,813,2
638,2021-08-26 14:00:00,3197.0,895,2302,895,0
639,2021-08-26 15:00:00,3799.0,1205,2599,1200,5
640,2021-08-26 16:00:00,4025.0,1158,2868,1157,1
641,2021-08-26 17:00:00,3961.0,2552,1479,2482,70
642,2021-08-26 18:00:00,2513.0,1291,1293,1220,71
643,2021-08-26 19:00:00,660.0,796,131,529,267
644,2021-08-26 20:00:00,0.0,982,0,0,982
645,2021-08-26 21:00:00,0.0,550,0,0,550
646,2021-08-26 22:00:00,0.0,970,0,0,970
647,2021-08-26 23:00:00,0.0,497,0,0,497
648,2021-08-27 00:00:00,0.0,1530,0,0,1530
649,2021-08-27 01:00:00,0.0,498,0,0,498
650,2021-08-27 02:00:00,0.0,327,0,0,327
651,2021-08-27 03:00:00,0.0,532,0,0,532
652,2021-08-27 04:00:00,0.0,329,0,0,329
653,2021-08-27 05:00:00,0.0,456,0,0,456
654,2021-08-27 06:00:00,5.0,484,0,5,479
655,2021-08-27 07:00:00,193.0,461,0,193,268
656,2021-08-27 08:00:00,509.0,1441,29,480,961
657,2021-08-27 09:00:00,832.0,856,218,614,242
658,2021-08-27 10:00:00,1323.0,782,559,764,18
659,2021-08-27 11:00:00,1164.0,570,612,552,18
660,2021-08-27 12:00:00,1500.0,698,825,675,23
661,2021-08-27 13:00:00,1341.0,1033,540,801,232
662,2021-08-27 14:00:00,1176.0,1877,162,1014,863
663,2021-08-27 15:00:00,867.0,666,254,613,53
664,2021-08-27 16:00:00,727.0,764,115,612,152
665,2021-08-27 17:00:00,1369.0,984,662,707,277
666,2021-08-27 18:00:00,228.0,1715,2,226,1489
667,2021-08-27 19:00:00,19.0,1589,0,19,1570
668,2021-08-27 20:00:00,0.0,1075,0,0,1075
669,2021-08-27 21:00:00,0.0,843,0,0,843
670,2021-08-27 22:00:00,0.0,968,0,0,968
671,2021-08-27 23:00:00,0.0,551,0,0,551
672,2021-08-28 00:00:00,0.0,510,0,0,510
673,2021-08-28 01:00:00,0.0,775,0,0,775
674,2021-08-28 02:00:00,0.0,1366,0,0,1366
675,2021-08-28 03:00:00,0.0,415,0,0,415
676,2021-08-28 04:00:00,0.0,525,0,0,525
677,2021-08-28 05:00:00,0.0,407,0,0,407
678,2021-08-28 06:00:00,1.0,563,0,1,562
679,2021-08-28 07:00:00,96.0,831,0,96,735
680,2021-08-28 08:00:00,305.0,651,8,297,354
681,2021-08-28 09:00:00,803.0,1354,235,568,786
682,2021-08-28 10:00:00,1085.0,1177,413,672,505
683,2021-08-28 11:00:00,1077.0,794,344,733,61
684,2021-08-28 12:00:00,1691.0,670,1030,661,9
685,2021-08-28 13:00:00,2300.0,791,1526,774,17
686,2021-08-28 14:00:00,1681.0,536,1165,516,20
687,2021-08-28 15:00:00,2126.0,785,1344,782,3
688,2021-08-28 16:00:00,3566.0,1685,2132,1434,251
689,2021-08-28 17:00:00,3879.0,940,2939,940,0
690,2021-08-28 18:00:00,1623.0,1363,909,714,649
691,2021-08-28 19:00:00,1174.0,1247,301,873,374
692,2021-08-28 20:00:00,0.0,968,0,0,968
693,2021-08-28 21:00:00,0.0,1068,0,0,1068
694,2021-08-28 22:00:00,0.0,1606,0,0,1606
695,2021-08-28 23:00:00,0.0,1003,0,0,1003
696,2021-08-29 00:00:00,0.0,363,0,0,363
697,2021-08-29 01:00:00,0.0,521,0,0,521
698,2021-08-29 02:00:00,0.0,752,0,0,752
699,2021-08-29 03:00:00,0.0,446,0,0,446
700,2021-08-29 04:00:00,0.0,348,0,0,348
701,2021-08-29 05:00:00,0.0,440,0,0,440
702,2021-08-29 06:00:00,12.0,403,0,12,391
703,2021-08-29 07:00:00,165.0,1134,0,165,969
704,2021-08-29 08:00:00,432.0,715,15,417,298
705,2021-08-29 09:00:00,496.0,841,75,421,420
706,2021-08-29 10:00:00,1037.0,1005,294,743,262
707,2021-08-29 11:00:00,1117.0,1318,239,878,440
708,2021-08-29 12:00:00,1110.0,1072,452,658,414
709,2021-08-29 13:00:00,1463.0,1178,584,879,299
710,2021-08-29 14:00:00,1221.0,1052,465,756,296
711,2021-08-29 15:00:00,816.0,1581,49,767,814
712,2021-08-29 16:00:00,730.0,1566,9,721,845
713,2021-08-29 17:00:00,740.0,1834,12,728,1106
714,2021-08-29 18:00:00,219.0,1478,0,219,1259
715,2021-08-29 19:00:00,25.0,1008,0,25,983
716,2021-08-29 20:00:00,0.0,828,0,0,828
717,2021-08-29 21:00:00,0.0,1168,0,0,1168
718,2021-08-29 22:00:00,0.0,653,0,0,653
719,2021-08-29 23:00:00,0.0,402,0,0,402
720,2021-08-30 00:00:00,0.0,516,0,0,516
721,2021-08-30 01:00:00,0.0,1137,0,0,1137
722,2021-08-30 02:00:00,0.0,484,0,0,484
723,2021-08-30 03:00:00,0.0,354,0,0,354
724,2021-08-30 04:00:00,0.0,400,0,0,400
725,2021-08-30 05:00:00,0.0,425,0,0,425
726,2021-08-30 06:00:00,0.0,414,0,0,414
727,2021-08-30 07:00:00,103.0,556,0,103,453
728,2021-08-30 08:00:00,238.0,1199,0,238,961
729,2021-08-30 09:00:00,562.0,1563,0,562,1001
730,2021-08-30 10:00:00,1062.0,672,506,556,116
731,2021-08-30 11:00:00,941.0,1046,310,631,415
732,2021-08-30 12:00:00,617.0,861,14,603,258
733,2021-08-30 13:00:00,564.0,1828,0,564,1264
734,2021-08-30 14:00:00,569.0,847,85,484,363
735,2021-08-30 15:00:00,558.0,1046,68,490,556
736,2021-08-30 16:00:00,349.0,582,0,349,233
737,2021-08-30 17:00:00,218.0,894,0,218,676
738,2021-08-30 18:00:00,59.0,821,0,59,762
739,2021-08-30 19:00:00,0.0,615,0,0,615
740,2021-08-30 20:00:00,0.0,1465,0,0,1465
741,2021-08-30 21:00:00,0.0,511,0,0,511
742,2021-08-30 22:00:00,0.0,474,0,0,474
743,2021-08-30 23:00:00,0.0,391,0,0,391
